iteration,field,quadrat,dilution.1,total.1,culmorum.1,dilution.2,total.2,culmorum.2,moisture,solids,c.ppg.1,c.ppg.2,t.ppg.1,t.ppg.2,f.c.ppg,f.ppg,culmorum,total
1,1,1,800,32,7,800,31,4,6,0.94,5957.446809,3404.255319,27234.04255,26382.97872,4680.851064,26808.51064,11,63
1,1,2,200,21,1,400,18,3,5.225,0.94775,211.0261145,1266.156687,4431.548404,7596.940121,738.5914007,6014.244263,4,39
1,1,3,400,24,1,800,22,1,6.45,0.9355,427.5788348,855.1576697,10261.89204,18813.46873,641.3682523,14537.68038,2,46
1,1,4,200,15,1,200,13,1,5.615,0.94385,211.898077,211.898077,3178.471155,2754.675001,211.898077,2966.573078,2,28
1,1,5,400,17,0,400,19,0,4.955,0.95045,0,0,7154.50576,7996.21232,0,7575.35904,0,36
1,1,6,400,16,0,800,15,2,4.58,0.9542,0,1676.797317,6707.189268,12575.97988,838.3986586,9641.584573,2,31
1,1,7,400,25,2,400,17,0,4.8,0.952,840.3361345,0,10504.20168,7142.857143,420.1680672,8823.529412,2,42
1,1,8,400,16,0,400,17,1,4.935,0.95065,0,420.7647399,6732.235839,7153.000579,210.38237,6942.618209,1,33
1,1,9,400,9,0,400,12,2,5.015,0.94985,0,842.2382481,3790.072117,5053.429489,421.1191241,4421.750803,2,21
1,2,1,800,13,1,800,14,3,8.295,0.91705,872.3624666,2617.0874,11340.71207,12213.07453,1744.724933,11776.8933,4,27
1,2,2,400,17,3,800,17,2,6.26,0.9374,1280.136548,1706.848731,7254.107105,14508.21421,1493.492639,10881.16066,5,34
1,2,3,400,26,1,800,19,0,4.255,0.95745,417.7763852,0,10862.18601,15875.50264,208.8881926,13368.84433,1,45
1,2,4,800,11,0,400,12,0,6.09,0.9391,0,0,9370.67405,5111.276754,0,7240.975402,0,23
1,2,5,800,9,1,800,12,0,5.465,0.94535,846.2474216,0,7616.226794,10154.96906,423.1237108,8885.597927,1,21
1,2,6,400,11,0,400,10,0,5.37,0.9463,0,0,4649.68826,4226.989327,0,4438.338793,0,21
1,2,7,400,11,0,400,12,0,6.075,0.93925,0,0,4684.588768,5110.460474,0,4897.524621,0,23
1,2,8,400,13,0,400,11,0,8.09,0.9191,0,0,5657.708628,4787.291916,0,5222.500272,0,24
1,2,9,400,10,1,200,15,1,4.945,0.95055,420.8090053,210.4045027,4208.090053,3156.06754,315.606754,3682.078796,2,25
1,3,1,400,20,0,400,24,1,5.28,0.9472,0,422.2972973,8445.945946,10135.13514,211.1486486,9290.540541,1,44
1,3,2,400,20,1,200,20,0,5,0.95,421.0526316,0,8421.052632,4210.526316,210.5263158,6315.789474,1,40
1,3,3,200,24,1,200,20,0,4.69,0.9531,209.8415696,0,5036.197671,4196.831392,104.9207848,4616.514532,1,44
1,3,4,400,23,3,400,18,2,4.485,0.95515,1256.347171,837.5647804,9631.994975,7538.083024,1046.955976,8585.038999,5,41
1,3,5,200,17,3,200,23,2,5.41,0.9459,634.3165239,422.8776826,3594.460302,4863.09335,528.5971033,4228.776826,5,40
1,3,6,200,14,0,400,18,0,4.495,0.95505,0,0,2931.783676,7538.87231,0,5235.327993,0,32
1,3,7,400,21,0,400,20,1,4.32,0.9568,0,418.0602007,8779.264214,8361.204013,209.0301003,8570.234114,1,41
1,3,8,200,21,4,200,23,6,5.065,0.94935,842.6818349,1264.022752,4424.079633,4845.420551,1053.352294,4634.750092,10,44
1,3,9,400,15,2,400,19,6,4.09,0.9591,834.1153164,2502.345949,6255.864873,7924.095506,1668.230633,7089.98019,8,34
1,4,1,200,30,0,400,21,0,3.775,0.96225,0,0,6235.385814,8729.54014,0,7482.462977,0,51
1,4,2,200,20,4,400,15,2,3.87,0.9613,832.2063872,832.2063872,4161.031936,6241.547904,832.2063872,5201.28992,6,35
1,4,3,200,16,3,400,11,1,4.505,0.95495,628.3051469,418.8700979,3350.960783,4607.571077,523.5876224,3979.26593,4,27
1,4,4,800,12,1,400,15,0,3.625,0.96375,830.0907912,0,9961.089494,6225.680934,415.0453956,8093.385214,1,27
1,4,5,200,12,2,400,12,2,4.215,0.95785,417.601921,835.2038419,2505.611526,5011.223052,626.4028815,3758.417289,4,24
1,4,6,200,20,1,400,11,2,5.335,0.94665,211.2713252,845.0853008,4225.426504,4647.969154,528.178313,4436.697829,3,31
1,4,7,200,19,0,200,19,1,3.53,0.9647,0,207.3183373,3939.048409,3939.048409,103.6591687,3939.048409,1,38
1,4,8,200,11,0,200,15,2,3.555,0.96445,0,414.7441547,2281.092851,3110.58116,207.3720773,2695.837006,2,26
1,4,9,200,11,0,200,11,1,3.68,0.9632,0,207.641196,2284.053156,2284.053156,103.820598,2284.053156,1,22
1,5,1,200,11,1,200,10,0,4.755,0.95245,209.9847761,0,2309.832537,2099.847761,104.9923881,2204.840149,1,21
1,5,2,800,14,5,800,11,4,4.13,0.9587,4172.316679,3337.853343,11682.4867,9179.096693,3755.085011,10430.7917,9,25
1,5,3,400,16,6,200,23,8,4.81,0.9519,2521.273243,1680.848829,6723.395315,4832.440382,2101.061036,5777.917849,14,39
1,5,4,200,10,0,200,8,0,4.995,0.95005,0,0,2105.15236,1684.121888,0,1894.637124,0,18
1,5,5,200,16,1,200,15,2,4.97,0.9503,210.4598548,420.9197096,3367.357677,3156.897822,315.6897822,3262.127749,3,31
1,5,6,200,17,3,200,20,3,4.54,0.9546,628.5355123,628.5355123,3561.701236,4190.236748,628.5355123,3875.968992,6,37
1,5,7,200,10,4,200,19,3,4.71,0.9529,839.5424494,629.656837,2098.856123,3987.826634,734.5996432,3043.341379,7,29
1,5,8,400,16,0,400,11,0,4.575,0.95425,0,0,6706.837831,4610.951009,0,5658.89442,0,27
1,5,9,200,11,0,200,5,0,4.725,0.95275,0,0,2309.105222,1049.593283,0,1679.349252,0,16
1,6,1,200,20,0,200,19,0,3.13,0.9687,0,0,4129.24538,3922.783111,0,4026.014246,0,39
1,6,2,200,20,0,200,18,0,2.96,0.9704,0,0,4122.011542,3709.810387,0,3915.910965,0,38
1,6,3,200,9,0,200,10,0,2.885,0.97115,0,0,1853.472687,2059.414097,0,1956.443392,0,19
1,6,4,200,15,0,200,19,0,3.085,0.96915,0,0,3095.496053,3920.961667,0,3508.22886,0,34
1,6,5,200,23,0,400,20,2,3.145,0.96855,0,825.9769759,4749.367611,8259.769759,412.9884879,6504.568685,2,43
1,6,6,200,17,0,200,21,0,3.195,0.96805,0,0,3512.215278,4338.618873,0,3925.417076,0,38
1,6,7,400,24,0,400,11,0,2.84,0.9716,0,0,9880.609304,4528.612598,0,7204.610951,0,35
1,6,8,400,15,0,400,16,1,2.96,0.9704,0,412.2011542,6183.017312,6595.218467,206.1005771,6389.11789,1,31
1,6,9,200,23,2,400,17,2,2.76,0.9724,411.3533525,822.7067051,4730.563554,6993.006993,617.0300288,5861.785274,4,40
1,7,1,100,12,0,100,10,0,2.56,0.9744,0,0,1231.527094,1026.272578,0,1128.899836,0,22
1,7,2,400,18,9,400,16,10,2.565,0.97435,3694.770873,4105.30097,7389.541746,6568.481552,3900.035921,6979.011649,19,34
1,7,3,400,11,0,200,15,0,2.55,0.9745,0,0,4515.135967,3078.501796,0,3796.818881,0,26
1,7,4,200,18,0,200,17,0,2.47,0.9753,0,0,3691.171947,3486.106839,0,3588.639393,0,35
1,7,5,200,15,0,200,19,1,2.48,0.9752,0,205.0861362,3076.292043,3896.636587,102.5430681,3486.464315,1,34
1,7,6,200,13,0,200,14,0,2.715,0.97285,0,0,2672.560004,2878.141543,0,2775.350774,0,27
1,7,7,200,15,0,200,13,0,2.415,0.97585,0,0,3074.242968,2664.343905,0,2869.293436,0,28
1,7,8,400,14,0,400,13,1,2.325,0.97675,0,409.5213719,5733.299207,5323.777835,204.7606859,5528.538521,1,27
1,7,9,100,18,0,100,12,0,2.545,0.97455,0,0,1847.006311,1231.33754,0,1539.171926,0,30
1,8,1,100,18,0,200,13,0,3.145,0.96855,0,0,1858.448196,2684.425172,0,2271.436684,0,31
1,8,2,100,18,0,100,14,0,2.715,0.97285,0,0,1850.233849,1439.070771,0,1644.65231,0,32
1,8,3,100,11,0,100,14,0,2.81,0.9719,0,0,1131.803684,1440.477415,0,1286.140549,0,25
1,8,4,200,14,1,200,15,0,2.825,0.97175,205.8142526,0,2881.399537,3087.21379,102.9071263,2984.306663,1,29
1,8,5,200,16,0,200,12,0,2.67,0.9733,0,0,3287.783828,2465.837871,0,2876.81085,0,28
1,8,6,200,9,1,200,10,0,2.575,0.97425,205.2861175,0,1847.575058,2052.861175,102.6430588,1950.218116,1,19
1,8,7,200,15,0,200,20,1,2.555,0.97445,0,205.2439838,3078.659757,4104.879676,102.6219919,3591.769716,1,35
1,8,8,100,10,0,100,15,1,2.465,0.97535,0,102.5272979,1025.272979,1537.909468,51.26364895,1281.591224,1,25
1,8,9,100,10,0,100,16,1,2.67,0.9733,0,102.7432446,1027.432446,1643.891914,51.37162232,1335.66218,1,26
1,9,1,400,19,0,400,25,0,2.2,0.978,0,0,7770.961145,10224.94888,0,8997.95501,0,44
1,9,2,400,11,0,400,19,0,2.475,0.97525,0,0,4511.663676,7792.873622,0,6152.268649,0,30
1,9,3,400,13,0,400,23,0,2.545,0.97455,0,0,5335.796008,9440.254476,0,7388.025242,0,36
1,9,4,200,20,0,400,12,0,2.23,0.9777,0,0,4091.23453,4909.481436,0,4500.357983,0,32
1,9,5,400,14,0,400,14,0,2.49,0.9751,0,0,5743.000718,5743.000718,0,5743.000718,0,28
1,9,6,400,15,0,400,18,0,2.54,0.9746,0,0,6156.371845,7387.646214,0,6772.009029,0,33
1,9,7,400,14,0,400,22,0,2.165,0.97835,0,0,5723.922931,8994.736035,0,7359.329483,0,36
1,9,8,400,18,1,400,16,0,2.32,0.9768,409.5004095,0,7371.007371,6552.006552,204.7502048,6961.506962,1,34
1,9,9,400,18,0,400,11,0,2.085,0.97915,0,0,7353.316652,4493.69351,0,5923.505081,0,29
2,1,1,400,18,0,400,11,0,2.64,0.9736,0,0,7395.234182,4519.309778,0,5957.27198,0,29
2,1,2,200,16,1,200,15,1,2.49,0.9751,205.1071685,205.1071685,3281.714696,3076.607527,205.1071685,3179.161112,2,31
2,1,3,200,19,1,400,14,1,2.865,0.97135,205.8990065,411.7980131,3912.081124,5765.172183,308.8485098,4838.626654,2,33
2,1,4,200,20,5,400,15,4,2.87,0.9713,1029.548028,1647.276845,4118.192114,6177.28817,1338.412437,5147.740142,9,35
2,1,5,200,18,1,400,15,3,3.26,0.9674,206.7397147,1240.438288,3721.314865,6202.191441,723.5890014,4961.753153,4,33
2,1,6,200,25,1,400,18,0,3.515,0.96485,207.2861066,0,5182.152666,7462.299839,103.6430533,6322.226253,1,43
2,1,7,400,13,8,400,17,9,2.49,0.9751,3281.714696,3691.929033,5332.786381,6973.643729,3486.821864,6153.215055,17,30
2,1,8,400,18,3,400,13,3,3.215,0.96785,1239.861549,1239.861549,7439.169293,5372.733378,1239.861549,6405.951335,6,31
2,1,9,400,10,1,400,21,3,2.82,0.9718,411.6073266,1234.82198,4116.073266,8643.753859,823.2146532,6379.913562,4,31
2,2,1,400,12,1,400,14,1,2.655,0.97345,410.9096512,410.9096512,4930.915815,5752.735117,410.9096512,5341.825466,2,26
2,2,2,400,11,1,400,13,1,2.865,0.97135,411.7980131,411.7980131,4529.778144,5353.37417,411.7980131,4941.576157,2,24
2,2,3,400,23,3,400,16,2,3.08,0.9692,1238.134544,825.4230293,9492.364837,6603.384234,1031.778787,8047.874536,5,39
2,2,4,200,14,0,200,18,0,3.11,0.9689,0,0,2889.875116,3715.553721,0,3302.714418,0,32
2,2,5,400,10,1,200,18,0,3.025,0.96975,412.4774426,0,4124.774426,3712.296984,206.2387213,3918.535705,1,28
2,2,6,400,14,1,400,15,0,3.085,0.96915,412.7328071,0,5778.259299,6190.992106,206.3664035,5984.625703,1,29
2,2,7,400,22,1,400,12,0,3.215,0.96785,413.2871829,0,9092.318024,4959.446195,206.6435915,7025.88211,1,34
2,2,8,400,15,0,200,15,1,3.275,0.96725,0,206.7717757,6203.15327,3101.576635,103.3858878,4652.364952,1,30
2,2,9,200,10,0,400,11,1,3.365,0.96635,0,413.9287008,2069.643504,4553.215709,206.9643504,3311.429606,1,21
2,3,1,400,16,2,400,15,0,3.42,0.9658,828.3288466,0,6626.630772,6212.466349,414.1644233,6419.548561,2,31
2,3,2,200,16,1,400,15,0,3.81,0.9619,207.9218214,0,3326.749142,6237.654642,103.9609107,4782.201892,1,31
2,3,3,400,18,0,400,24,0,3.42,0.9658,0,0,7454.959619,9939.946159,0,8697.452889,0,42
2,3,4,400,13,1,400,13,0,3.24,0.9676,413.3939644,0,5374.121538,5374.121538,206.6969822,5374.121538,1,26
2,3,5,400,12,1,200,14,1,3.135,0.96865,412.9458525,206.4729262,4955.35023,2890.620967,309.7093894,3922.985599,2,26
2,3,6,400,18,1,400,11,0,3.03,0.9697,412.4987109,0,7424.976797,4537.48582,206.2493555,5981.231309,1,29
2,3,7,400,19,1,400,19,1,3.105,0.96895,412.8179989,412.8179989,7843.541978,7843.541978,412.8179989,7843.541978,2,38
2,3,8,400,10,1,400,10,0,2.805,0.97195,411.5438037,0,4115.438037,4115.438037,205.7719018,4115.438037,1,20
2,3,9,200,19,10,400,12,5,3.275,0.96725,2067.717757,2067.717757,3928.663737,4962.522616,2067.717757,4445.593177,15,31
2,4,1,200,12,1,400,19,3,3.03,0.9697,206.2493555,1237.496133,2474.992266,7837.475508,721.8727441,5156.233887,4,31
2,4,2,100,13,1,400,16,1,2.6,0.974,102.6694045,410.6776181,1334.702259,6570.841889,256.6735113,3952.772074,2,29
2,4,3,100,20,10,100,14,5,2.545,0.97455,1026.114617,513.0573085,2052.229234,1436.560464,769.5859628,1744.394849,15,34
2,4,4,200,20,1,200,12,1,2.9,0.971,205.9732235,205.9732235,4119.46447,2471.678682,205.9732235,3295.571576,2,32
2,4,5,200,15,3,200,11,1,2.59,0.9741,615.9531876,205.3177292,3079.765938,2258.495021,410.6354584,2669.130479,4,26
2,4,6,200,15,1,200,13,0,3.295,0.96705,206.8145391,0,3102.218086,2688.589008,103.4072695,2895.403547,1,28
2,4,7,200,11,2,200,11,5,2.57,0.9743,410.5511649,1026.377912,2258.031407,2258.031407,718.4645386,2258.031407,7,22
2,4,8,100,19,14,100,12,2,2.52,0.9748,1436.192039,205.1702913,1949.117768,1231.021748,820.6811654,1590.069758,16,31
2,4,9,200,14,1,200,14,1,2.255,0.97745,204.6140468,204.6140468,2864.596655,2864.596655,204.6140468,2864.596655,2,28
2,5,1,100,10,0,100,11,0,2.875,0.97125,0,0,1029.60103,1132.561133,0,1081.081081,0,21
2,5,2,200,15,4,200,16,1,2.285,0.97715,818.7074656,204.6768664,3070.152996,3274.829862,511.692166,3172.491429,5,31
2,5,3,100,16,15,100,19,11,2.11,0.9789,1532.33221,1123.710287,1634.48769,1940.954132,1328.021248,1787.720911,26,35
2,5,4,100,18,0,100,17,0,3.115,0.96885,0,0,1857.872736,1754.657584,0,1806.26516,0,35
2,5,5,100,12,1,100,12,1,2.4,0.976,102.4590164,102.4590164,1229.508197,1229.508197,102.4590164,1229.508197,2,24
2,5,6,200,20,16,200,18,15,2.735,0.97265,3289.98098,3084.357169,4112.476225,3701.228602,3187.169074,3906.852414,31,38
2,5,7,100,12,1,200,10,4,2.27,0.9773,102.3227259,818.581807,1227.872711,2046.454518,460.4522664,1637.163614,5,22
2,5,8,200,14,1,100,21,3,2.645,0.97355,205.4337219,308.1505829,2876.072107,2157.05408,256.7921524,2516.563094,4,35
2,5,9,100,20,2,100,14,0,2.95,0.9705,206.0793405,0,2060.793405,1442.555384,103.0396703,1751.674395,2,34
2,6,1,400,23,0,200,23,0,2.36,0.9764,0,0,9422.367882,4711.183941,0,7066.775912,0,46
2,6,2,100,17,6,100,18,5,2.25,0.9775,613.8107417,511.5089514,1739.130435,1841.432225,562.6598465,1790.28133,11,35
2,6,3,200,11,0,200,14,0,1.995,0.98005,0,0,2244.783429,2856.997092,0,2550.890261,0,25
2,6,4,100,15,0,200,13,0,2.32,0.9768,0,0,1535.626536,2661.752662,0,2098.689599,0,28
2,6,5,100,21,2,200,20,1,2.645,0.97355,205.4337219,205.4337219,2157.05408,4108.674439,205.4337219,3132.86426,3,41
2,6,6,100,12,0,200,8,0,2.56,0.9744,0,0,1231.527094,1642.036125,0,1436.781609,0,20
2,6,7,100,16,0,200,20,0,2.675,0.97325,0,0,1643.976368,4109.94092,0,2876.958644,0,36
2,6,8,200,18,0,100,18,0,2.345,0.97655,0,0,3686.447187,1843.223593,0,2764.83539,0,36
2,6,9,200,18,0,200,12,1,2.21,0.9779,0,204.5198896,3681.358012,2454.238675,102.2599448,3067.798343,1,30
2,7,1,100,11,0,100,18,0,2.445,0.97555,0,0,1127.569064,1845.113013,0,1486.341038,0,29
2,7,2,200,17,0,100,20,0,2.295,0.97705,0,0,3479.862852,2046.978149,0,2763.4205,0,37
2,7,3,200,15,0,100,16,0,2.21,0.9779,0,0,3067.798343,1636.159116,0,2351.97873,0,31
2,7,4,100,19,0,100,17,0,2.01,0.9799,0,0,1938.973365,1734.870905,0,1836.922135,0,36
2,7,5,200,11,0,200,16,0,2.2,0.978,0,0,2249.488753,3271.98364,0,2760.736196,0,27
2,7,6,200,12,0,200,12,0,2.405,0.97595,0,0,2459.142374,2459.142374,0,2459.142374,0,24
2,7,7,200,13,0,200,13,1,1.955,0.98045,0,203.9879647,2651.843541,2651.843541,101.9939824,2651.843541,1,26
2,7,8,200,12,0,100,18,0,1.98,0.9802,0,0,2448.479902,1836.359927,0,2142.419914,0,30
2,7,9,100,11,0,200,13,0,2.05,0.9795,0,0,1123.02195,2654.415518,0,1888.718734,0,24
2,8,1,100,16,0,100,22,0,2.855,0.97145,0,0,1647.022492,2264.655927,0,1955.839209,0,38
2,8,2,100,14,1,100,13,0,2.23,0.9777,102.2808633,0,1431.932086,1329.651222,51.14043163,1380.791654,1,27
2,8,3,100,16,0,100,19,0,2.22,0.9778,0,0,1636.326447,1943.137656,0,1789.732052,0,35
2,8,4,100,10,0,100,14,0,2.195,0.97805,0,0,1022.442615,1431.419662,0,1226.931138,0,24
2,8,5,200,19,0,100,16,0,2.17,0.9783,0,0,3884.289073,1635.490136,0,2759.889604,0,35
2,8,6,100,12,0,100,14,0,2.17,0.9783,0,0,1226.617602,1431.053869,0,1328.835735,0,26
2,8,7,100,10,0,100,10,0,2.595,0.97405,0,0,1026.641343,1026.641343,0,1026.641343,0,20
2,8,8,100,14,0,100,10,0,2.365,0.97635,0,0,1433.912019,1024.222871,0,1229.067445,0,24
2,8,9,100,15,0,100,15,0,2.34,0.9766,0,0,1535.94102,1535.94102,0,1535.94102,0,30
2,9,1,100,18,0,200,20,0,1.865,0.98135,0,0,1834.207979,4076.017731,0,2955.112855,0,38
2,9,2,100,17,0,200,21,0,2.025,0.97975,0,0,1735.136514,4286.807859,0,3010.972187,0,38
2,9,3,200,17,0,200,12,0,2.38,0.9762,0,0,3482.89285,2458.5126,0,2970.702725,0,29
2,9,4,100,13,0,100,14,0,1.83,0.9817,0,0,1324.233473,1426.097586,0,1375.165529,0,27
2,9,5,100,16,0,100,14,0,2.16,0.9784,0,0,1635.322976,1430.907604,0,1533.11529,0,30
2,9,6,100,16,0,200,17,0,2.28,0.9772,0,0,1637.33115,3479.328694,0,2558.329922,0,33
2,9,7,200,18,0,200,25,0,2.145,0.97855,0,0,3678.912677,5109.60094,0,4394.256809,0,43
2,9,8,200,15,0,200,15,0,2.185,0.97815,0,0,3067.014262,3067.014262,0,3067.014262,0,30
2,9,9,200,19,0,200,18,1,2.19,0.9781,0,204.4780697,3885.083325,3680.605255,102.2390349,3782.84429,1,37
3,1,1,100,12,6,100,10,3,2.505,0.97495,615.4161752,307.7080876,1230.83235,1025.693625,461.5621314,1128.262988,9,22
3,1,2,200,10,2,100,10,0,2.42,0.9758,409.9200656,0,2049.600328,1024.800164,204.9600328,1537.200246,2,20
3,1,3,100,12,0,100,11,0,2.27,0.9773,0,0,1227.872711,1125.549985,0,1176.711348,0,23
3,1,4,100,16,1,100,13,1,2.785,0.97215,102.8647842,102.8647842,1645.836548,1337.242195,102.8647842,1491.539371,2,29
3,1,5,100,16,0,100,12,0,3.09,0.9691,0,0,1651.016407,1238.262305,0,1444.639356,0,28
3,1,6,100,13,0,200,15,0,2.63,0.9737,0,0,1335.113485,3081.031118,0,2208.072302,0,28
3,1,7,100,18,14,100,22,16,2.13,0.9787,1430.468989,1634.821702,1839.174415,2247.879841,1532.645346,2043.527128,30,40
3,1,8,200,15,4,200,22,8,2.015,0.97985,816.4514977,1632.902995,3061.693116,4490.483237,1224.677247,3776.088177,12,37
3,1,9,100,17,9,200,14,2,2.045,0.97955,918.78924,408.3507733,1735.490787,2858.455413,663.5700066,2296.9731,11,31
3,2,1,400,14,0,400,16,1,1.845,0.98155,0,407.5187204,5705.262085,6520.299526,203.7593602,6112.780806,1,30
3,2,2,400,22,2,400,15,2,1.905,0.98095,815.53596,815.53596,8970.89556,6116.5197,815.53596,7543.70763,4,37
3,2,3,400,16,0,400,16,0,1.99,0.9801,0,0,6529.945924,6529.945924,0,6529.945924,0,32
3,2,4,400,16,1,400,12,2,2.185,0.97815,408.9352349,817.8704698,6542.963758,4907.222819,613.4028523,5725.093288,3,28
3,2,5,200,14,1,200,21,1,2.21,0.9779,204.5198896,204.5198896,2863.278454,4294.917681,204.5198896,3579.098067,2,35
3,2,6,200,15,0,400,16,0,2.065,0.97935,0,0,3063.256241,6534.946648,0,4799.101445,0,31
3,2,7,400,16,0,200,11,1,2.195,0.97805,0,204.4885231,6543.632739,2249.373754,102.2442615,4396.503246,1,27
3,2,8,200,20,1,400,12,0,2.26,0.9774,204.624514,0,4092.49028,4910.988336,102.312257,4501.739308,1,32
3,2,9,200,22,3,200,16,0,1.93,0.9807,611.8078923,0,4486.59121,3262.975426,305.9039462,3874.783318,3,38
3,3,1,100,15,0,100,17,1,2.25,0.9775,0,102.3017903,1534.526854,1739.130435,51.15089514,1636.828645,1,32
3,3,2,200,17,1,200,15,1,2.435,0.97565,204.9915441,204.9915441,3484.85625,3074.873161,204.9915441,3279.864706,2,32
3,3,3,400,12,1,200,13,1,1.955,0.98045,407.9759294,203.9879647,4895.711153,2651.843541,305.9819471,3773.777347,2,25
3,3,4,100,13,1,100,15,1,2.07,0.9793,102.1137547,102.1137547,1327.478811,1531.706321,102.1137547,1429.592566,2,28
3,3,5,200,14,0,400,14,0,2.385,0.97615,0,0,2868.411617,5736.823234,0,4302.617426,0,28
3,3,6,100,20,1,200,13,4,1.99,0.9801,102.0304051,816.2432405,2040.608101,2652.790532,459.1368228,2346.699316,5,33
3,3,7,200,28,0,400,26,0,1.85,0.9815,0,0,5705.552725,10596.02649,0,8150.789608,0,54
3,3,8,100,29,18,200,17,5,1.84,0.9816,1833.740831,1018.744906,2954.360228,3463.732681,1426.242869,3209.046455,23,46
3,3,9,100,11,0,400,10,2,2,0.98,0,816.3265306,1122.44898,4081.632653,408.1632653,2602.040816,2,21
3,4,1,400,16,0,400,20,0,2.91,0.9709,0,0,6591.822021,8239.777526,0,7415.799773,0,36
3,4,2,400,22,1,400,18,0,2.6,0.974,410.6776181,0,9034.907598,7392.197125,205.338809,8213.552361,1,40
3,4,3,400,32,13,400,12,3,2.255,0.97745,5319.965216,1227.684281,13095.29899,4910.737122,3273.824748,9003.018057,16,44
3,4,4,400,22,0,400,14,0,2.765,0.97235,0,0,9050.239111,5759.243071,0,7404.741091,0,36
3,4,5,400,18,2,400,17,4,5.305,0.94695,844.8175722,1689.635144,7603.35815,7180.949364,1267.226358,7392.153757,6,35
3,4,6,400,20,4,400,23,9,3.02,0.9698,1649.824706,3712.105589,8249.123531,9486.49206,2680.965147,8867.807795,13,43
3,4,7,200,21,20,200,15,10,3.04,0.9696,4125.412541,2062.706271,4331.683168,3094.059406,3094.059406,3712.871287,30,36
3,4,8,400,25,9,400,30,10,2.655,0.97345,3698.186861,4109.096512,10272.74128,12327.28954,3903.641687,11300.01541,19,55
3,4,9,200,18,1,200,15,0,2.195,0.97805,204.4885231,0,3680.793415,3067.327846,102.2442615,3374.060631,1,33
3,5,1,100,12,1,100,16,1,2.83,0.9717,102.9124215,102.9124215,1234.949058,1646.598744,102.9124215,1440.773901,2,28
3,5,2,200,20,9,200,15,5,3.365,0.96635,1862.679154,1034.821752,4139.287008,3104.465256,1448.750453,3621.876132,14,35
3,5,3,400,18,2,400,15,0,2.215,0.97785,818.1213888,0,7363.092499,6135.910416,409.0606944,6749.501457,2,33
3,5,4,100,22,1,200,15,1,2.88,0.9712,102.9654036,205.9308072,2265.23888,3088.962109,154.4481054,2677.100494,2,37
3,5,5,200,22,8,400,13,4,2.225,0.97775,1636.410125,1636.410125,4500.127845,5318.332907,1636.410125,4909.230376,12,35
3,5,6,400,19,0,400,17,2,2.2,0.978,0,817.99591,7770.961145,6952.965235,408.997955,7361.96319,2,36
3,5,7,400,15,5,200,16,4,2.3,0.977,2047.082907,818.8331627,6141.248721,3275.332651,1432.958035,4708.290686,9,31
3,5,8,200,13,1,100,18,0,3.13,0.9687,206.462269,0,2684.009497,1858.160421,103.2311345,2271.084959,1,31
3,5,9,400,14,0,400,18,0,2.345,0.97655,0,0,5734.473401,7372.894373,0,6553.683887,0,32
3,6,1,100,17,0,100,12,0,1.925,0.98075,0,0,1733.367321,1223.553403,0,1478.460362,0,29
3,6,2,100,18,1,200,14,3,1.825,0.98175,101.8589254,611.1535523,1833.460657,2852.049911,356.5062389,2342.755284,4,32
3,6,3,200,18,0,400,17,0,1.915,0.98085,0,0,3670.285976,6932.7624,0,5301.524188,0,35
3,6,4,100,19,0,100,13,1,2.385,0.97615,0,102.443272,1946.422169,1331.762536,51.22163602,1639.092353,1,32
3,6,5,200,22,7,200,21,5,4.285,0.95715,1462.675652,1044.768323,4596.98062,4388.026955,1253.721987,4492.503787,12,43
3,6,6,200,25,0,400,27,0,4.08,0.9592,0,0,5212.677231,11259.38282,0,8236.030025,0,52
3,6,7,200,23,4,200,20,3,2.94,0.9706,824.2324335,618.1743252,4739.336493,4121.162168,721.2033794,4430.24933,7,43
3,6,8,400,27,8,400,27,7,3.105,0.96895,3302.543991,2889.725992,11146.08597,11146.08597,3096.134991,11146.08597,15,54
3,6,9,400,24,6,400,30,4,2.55,0.9745,2462.801437,1641.867624,9851.205747,12314.00718,2052.334531,11082.60646,10,54
3,7,1,200,14,0,200,11,0,1.64,0.9836,0,0,2846.685645,2236.681578,0,2541.683611,0,25
3,7,2,200,19,0,200,16,0,1.95,0.9805,0,0,3875.573687,3263.640999,0,3569.607343,0,35
3,7,3,200,10,0,200,15,0,1.775,0.98225,0,0,2036.141512,3054.212268,0,2545.17689,0,25
3,7,4,200,17,0,200,16,1,1.695,0.98305,0,203.4484512,3458.623671,3255.17522,101.7242256,3356.899446,1,33
3,7,5,200,17,1,200,18,1,1.87,0.9813,203.8112708,203.8112708,3464.791603,3668.602874,203.8112708,3566.697238,2,35
3,7,6,400,25,0,400,22,0,1.825,0.98175,0,0,10185.89254,8963.585434,0,9574.738987,0,47
3,7,7,400,25,0,400,25,0,1.67,0.9833,0,0,10169.83627,10169.83627,0,10169.83627,0,50
3,7,8,400,20,0,400,14,1,1.68,0.9832,0,406.8348251,8136.696501,5695.687551,203.4174125,6916.192026,1,34
3,7,9,200,23,0,200,20,0,1.66,0.9834,0,0,4677.648973,4067.520846,0,4372.584909,0,43
3,8,1,100,17,0,100,17,0,2.035,0.97965,0,0,1735.313632,1735.313632,0,1735.313632,0,34
3,8,2,100,15,0,100,19,0,1.78,0.9822,0,0,1527.183873,1934.432906,0,1730.808389,0,34
3,8,3,100,11,0,100,14,0,1.85,0.9815,0,0,1120.733571,1426.388181,0,1273.560876,0,25
3,8,4,100,22,0,100,15,0,1.765,0.98235,0,0,2239.527663,1526.950679,0,1883.239171,0,37
3,8,5,200,12,0,200,18,0,1.85,0.9815,0,0,2445.236882,3667.855323,0,3056.546103,0,30
3,8,6,100,24,0,200,13,0,1.795,0.98205,0,0,2443.86742,2647.523039,0,2545.695229,0,37
3,8,7,100,17,0,100,19,2,1.815,0.98185,0,203.6971024,1731.42537,1935.122473,101.8485512,1833.273922,2,36
3,8,8,100,25,0,100,25,0,1.92,0.9808,0,0,2548.939641,2548.939641,0,2548.939641,0,50
3,8,9,100,19,0,100,20,0,1.835,0.98165,0,0,1935.516732,2037.386034,0,1986.451383,0,39
3,9,1,100,17,0,200,12,0,1.73,0.9827,0,0,1729.92775,2442.250941,0,2086.089346,0,29
3,9,2,400,14,0,400,12,0,1.57,0.9843,0,0,5689.322361,4876.562024,0,5282.942192,0,26
3,9,3,200,12,0,200,22,0,1.705,0.98295,0,0,2441.629788,4476.321278,0,3458.975533,0,34
3,9,4,200,11,0,200,13,0,1.64,0.9836,0,0,2236.681578,2643.350956,0,2440.016267,0,24
3,9,5,200,14,0,200,15,0,1.62,0.9838,0,0,2846.106932,3049.400285,0,2947.753608,0,29
3,9,6,200,18,0,400,14,0,1.97,0.9803,0,0,3672.3452,5712.536978,0,4692.441089,0,32
3,9,7,200,16,0,200,16,0,1.73,0.9827,0,0,3256.334588,3256.334588,0,3256.334588,0,32
3,9,8,200,14,0,200,21,0,1.68,0.9832,0,0,2847.843775,4271.765663,0,3559.804719,0,35
3,9,9,200,12,0,200,20,0,1.645,0.98355,0,0,2440.140308,4066.900513,0,3253.520411,0,32
4,1,1,400,18,6,400,19,3,3.805,0.96195,2494.932169,1247.466085,7484.796507,7900.618535,1871.199127,7692.707521,9,37
4,1,2,200,13,2,200,13,1,3.88,0.9612,416.1464836,208.0732418,2704.952143,2704.952143,312.1098627,2704.952143,3,26
4,1,3,400,16,0,400,14,1,3.41,0.9659,0,414.1215447,6625.944715,5797.701625,207.0607723,6211.82317,1,30
4,1,4,400,21,1,400,19,3,3.94,0.9606,416.4064127,1249.219238,8744.534666,7911.721841,832.8128253,8328.128253,4,40
4,1,5,200,14,1,200,18,0,3.81,0.9619,207.9218214,0,2910.9055,3742.592785,103.9609107,3326.749142,1,32
4,1,6,200,22,7,400,21,2,4.635,0.95365,1468.043832,838.8821895,4613.852042,8808.26299,1153.463011,6711.057516,9,43
4,1,7,400,16,2,400,14,0,4.015,0.95985,833.463562,0,6667.708496,5834.244934,416.731781,6250.976715,2,30
4,1,8,400,14,3,200,21,1,2.895,0.97105,1235.775707,205.9626178,5766.953298,4325.214973,720.8691622,5046.084136,4,35
4,1,9,200,20,2,400,10,2,4.345,0.95655,418.1694632,836.3389263,4181.694632,4181.694632,627.2541948,4181.694632,4,30
4,2,1,400,20,3,400,21,6,3.715,0.96285,1246.300047,2492.600093,8308.666978,8724.100327,1869.45007,8516.383653,9,41
4,2,2,400,19,4,400,22,4,2.665,0.97335,1643.807469,1643.807469,7808.085478,9040.94108,1643.807469,8424.513279,8,41
4,2,3,400,25,0,400,22,2,5.32,0.9468,0,844.9514153,10561.89269,9294.465568,422.4757076,9928.17913,2,47
4,2,4,400,24,1,400,20,0,2.815,0.97185,411.5861501,0,9878.067603,8231.723003,205.7930751,9054.895303,1,44
4,2,5,400,21,0,400,23,0,4.045,0.95955,0,0,8754.103486,9587.827628,0,9170.965557,0,44
4,2,6,400,24,1,400,25,1,3.755,0.96245,415.6060055,415.6060055,9974.544132,10390.15014,415.6060055,10182.34713,2,49
4,2,7,400,16,2,400,17,6,3.195,0.96805,826.4035949,2479.210785,6611.228759,7024.430556,1652.80719,6817.829658,8,33
4,2,8,400,20,3,400,14,2,3.98,0.9602,1249.739638,833.1597584,8331.597584,5832.118309,1041.449698,7081.857946,5,34
4,2,9,400,18,1,400,17,0,3.635,0.96365,415.0884657,0,7471.592383,7056.503917,207.5442329,7264.04815,1,35
4,3,1,200,16,1,200,15,1,2.605,0.97395,205.3493506,205.3493506,3285.589609,3080.240259,205.3493506,3182.914934,2,31
4,3,2,400,13,1,400,14,2,3.2,0.968,413.2231405,826.446281,5371.900826,5785.123967,619.8347107,5578.512397,3,27
4,3,3,200,14,3,400,19,4,2.905,0.97095,617.9514908,1647.870642,2883.773624,7827.38555,1132.911066,5355.579587,7,33
4,3,4,400,13,5,400,14,8,3.19,0.9681,2065.902283,3305.443653,5371.345935,5784.526392,2685.672968,5577.936164,13,27
4,3,5,200,16,5,200,18,4,3.565,0.96435,1036.967906,829.5743247,3318.297299,3733.084461,933.2711153,3525.69088,9,34
4,3,6,200,19,8,200,22,9,3.35,0.9665,1655.457838,1862.390067,3931.712364,4552.509053,1758.923952,4242.110709,17,41
4,3,7,400,15,6,400,12,2,4.13,0.9587,2503.390007,834.4633358,6258.475018,5006.780015,1668.926672,5632.627516,8,27
4,3,8,400,16,8,400,20,7,3.8,0.962,3326.403326,2910.602911,6652.806653,8316.008316,3118.503119,7484.407484,15,36
4,3,9,400,15,2,400,17,5,3.08,0.9692,825.4230293,2063.557573,6190.67272,7016.095749,1444.490301,6603.384234,7,32
4,4,1,400,15,2,400,11,2,3.215,0.96785,826.5743659,826.5743659,6199.307744,4546.159012,826.5743659,5372.733378,4,26
4,4,2,400,18,1,400,19,1,3.565,0.96435,414.7871623,414.7871623,7466.168922,7880.956084,414.7871623,7673.562503,2,37
4,4,3,400,18,9,400,14,6,3.19,0.9681,3718.624109,2479.082739,7437.248218,5784.526392,3098.853424,6610.887305,15,32
4,4,4,200,14,3,200,12,1,3.08,0.9692,619.067272,206.3557573,2888.980603,2476.269088,412.7115147,2682.624845,4,26
4,4,5,200,15,7,200,16,5,2.95,0.9705,1442.555384,1030.396703,3091.190108,3297.269449,1236.476043,3194.229778,12,31
4,4,6,200,18,3,200,14,5,3.51,0.9649,621.826096,1036.376827,3730.956576,2901.855115,829.1014613,3316.405845,8,32
4,4,7,200,18,11,200,20,8,3.655,0.96345,2283.460481,1660.698531,3736.571695,4151.746328,1972.079506,3944.159012,19,38
4,4,8,400,18,8,400,19,8,4.295,0.95705,3343.607962,3343.607962,7523.117914,7941.06891,3343.607962,7732.093412,16,37
4,4,9,400,18,1,400,13,6,2.85,0.9715,411.7344313,2470.406588,7411.219763,5352.547607,1441.07051,6381.883685,7,31
4,5,1,200,20,0,200,14,1,3.595,0.96405,0,207.4581194,4149.162388,2904.413671,103.7290597,3526.78803,1,34
4,5,2,200,21,10,400,13,6,2.87,0.9713,2059.096057,2470.915268,4324.101719,5353.649748,2265.005663,4838.875734,16,34
4,5,3,200,13,3,100,15,8,2.59,0.9741,615.9531876,821.2709167,2669.130479,1539.882969,718.6120522,2104.506724,11,28
4,5,4,200,10,0,200,10,0,3.865,0.96135,0,0,2080.40776,2080.40776,0,2080.40776,0,20
4,5,5,200,16,0,200,17,1,3.545,0.96455,0,207.350578,3317.609248,3524.959826,103.675289,3421.284537,1,33
4,5,6,200,12,4,200,10,5,3.155,0.96845,826.0622644,1032.577831,2478.186793,2065.155661,929.3200475,2271.671227,9,22
4,5,7,200,15,7,200,18,7,3.985,0.96015,1458.105504,1458.105504,3124.511795,3749.414154,1458.105504,3436.962975,14,33
4,5,8,200,12,0,100,21,0,3.49,0.9651,0,0,2486.788934,2175.940317,0,2331.364625,0,33
4,5,9,200,16,2,200,16,0,3.175,0.96825,413.1164472,0,3304.931578,3304.931578,206.5582236,3304.931578,2,32
4,6,1,200,18,0,200,14,0,2.56,0.9744,0,0,3694.581281,2873.563218,0,3284.07225,0,32
4,6,2,200,14,0,200,20,0,2.93,0.9707,0,0,2884.516328,4120.737612,0,3502.62697,0,34
4,6,3,200,17,0,200,13,0,2.385,0.97615,0,0,3483.071249,2663.525073,0,3073.298161,0,30
4,6,4,200,16,0,200,12,0,2.715,0.97285,0,0,3289.30462,2466.978465,0,2878.141543,0,28
4,6,5,200,18,4,200,17,6,3.07,0.9693,825.3378727,1238.006809,3714.020427,3507.685959,1031.672341,3610.853193,10,35
4,6,6,400,22,0,400,18,0,3.195,0.96805,0,0,9090.439543,7437.632354,0,8264.035949,0,40
4,6,7,100,18,0,200,14,0,2.665,0.97335,0,0,1849.283403,2876.663071,0,2362.973237,0,32
4,6,8,400,25,2,400,12,3,4.44,0.9556,837.1703642,1255.755546,10464.62955,5023.022185,1046.462955,7743.825869,5,37
4,6,9,400,15,1,200,20,3,2.74,0.9726,411.2687641,616.9031462,6169.031462,4112.687641,514.0859552,5140.859552,4,35
4,7,1,100,17,0,100,17,0,2.245,0.97755,0,0,1739.041481,1739.041481,0,1739.041481,0,34
4,7,2,400,16,0,400,14,0,2.55,0.9745,0,0,6567.470498,5746.536685,0,6157.003592,0,30
4,7,3,400,14,0,200,14,0,2.12,0.9788,0,0,5721.291377,2860.645689,0,4290.968533,0,28
4,7,4,400,16,0,400,15,0,2.2,0.978,0,0,6543.96728,6134.969325,0,6339.468303,0,31
4,7,5,400,17,0,400,17,0,2.385,0.97615,0,0,6966.142499,6966.142499,0,6966.142499,0,34
4,7,6,400,18,0,400,13,0,2.685,0.97315,0,0,7398.653856,5343.472229,0,6371.063043,0,31
4,7,7,200,13,0,200,13,0,2.98,0.9702,0,0,2679.859823,2679.859823,0,2679.859823,0,26
4,7,8,200,17,1,400,16,0,3.44,0.9656,207.1251036,0,3521.126761,6628.003314,103.5625518,5074.565037,1,33
4,7,9,400,13,0,400,15,0,3.23,0.9677,0,0,5373.566188,6200.268678,0,5786.917433,0,28
4,8,1,200,16,1,200,13,0,2.865,0.97135,205.8990065,0,3294.384105,2676.687085,102.9495033,2985.535595,1,29
4,8,2,100,20,0,100,12,0,2.505,0.97495,0,0,2051.387251,1230.83235,0,1641.109801,0,32
4,8,3,100,19,0,100,19,0,2.47,0.9753,0,0,1948.118528,1948.118528,0,1948.118528,0,38
4,8,4,200,17,0,200,15,2,2.52,0.9748,0,410.3405827,3487.894953,3077.55437,205.1702913,3282.724661,2,32
4,8,5,100,18,0,200,16,0,3.505,0.96495,0,0,1865.381626,3316.234002,0,2590.807814,0,34
4,8,6,400,15,0,200,19,0,2.66,0.9734,0,0,6163.961373,3903.842203,0,5033.901788,0,34
4,8,7,100,16,0,200,22,0,2.705,0.97295,0,0,1644.483273,4522.328999,0,3083.406136,0,38
4,8,8,100,14,0,100,14,1,2.955,0.97045,0,103.0449791,1442.629708,1442.629708,51.52248957,1442.629708,1,28
4,8,9,200,12,0,200,13,0,3.29,0.9671,0,0,2481.646159,2688.450005,0,2585.048082,0,25
4,9,1,200,14,0,200,16,0,1.925,0.98075,0,0,2854.95794,3262.809075,0,3058.883508,0,30
4,9,2,100,12,0,100,13,0,2.105,0.97895,0,0,1225.803156,1327.953419,0,1276.878288,0,25
4,9,3,200,14,0,200,16,0,2.19,0.9781,0,0,2862.692976,3271.649116,0,3067.171046,0,30
4,9,4,100,16,0,100,16,0,2.21,0.9779,0,0,1636.159116,1636.159116,0,1636.159116,0,32
4,9,5,100,16,0,100,18,0,2.155,0.97845,0,0,1635.239409,1839.644335,0,1737.441872,0,34
4,9,6,100,16,0,200,18,0,2.14,0.9786,0,0,1634.988759,3678.724709,0,2656.856734,0,34
4,9,7,400,13,0,400,13,0,2.78,0.9722,0,0,5348.693684,5348.693684,0,5348.693684,0,26
4,9,8,100,20,0,100,18,0,2.92,0.9708,0,0,2060.156572,1854.140915,0,1957.148743,0,38
4,9,9,100,20,1,200,15,0,2.005,0.97995,102.0460228,0,2040.920455,3061.380683,51.02301138,2551.150569,1,35
5,1,1,400,10,2,400,14,1,5.48,0.9452,846.3817182,423.1908591,4231.908591,5924.672027,634.7862886,5078.290309,3,24
5,1,2,200,18,3,200,12,1,5.97,0.9403,638.0942252,212.6980751,3828.565351,2552.376901,425.3961502,3190.471126,4,30
5,1,3,200,14,2,200,13,0,4.465,0.95535,418.6947192,0,2930.863034,2721.515675,209.3473596,2826.189355,2,27
5,1,4,400,21,4,400,16,5,3.57,0.9643,1659.234678,2074.043348,8710.98206,6636.938712,1866.639013,7673.960386,9,37
5,1,5,200,15,0,200,21,0,4.32,0.9568,0,0,3135.451505,4389.632107,0,3762.541806,0,36
5,1,6,400,15,1,400,15,0,4.44,0.9556,418.5851821,0,6278.777731,6278.777731,209.292591,6278.777731,1,30
5,1,7,400,16,3,400,15,5,3.305,0.96695,1241.015564,2068.359274,6618.749677,6205.077822,1654.687419,6411.913749,8,31
5,1,8,200,14,2,200,16,4,3.275,0.96725,413.5435513,827.0871026,2894.804859,3308.34841,620.315327,3101.576635,6,30
5,1,9,400,17,2,200,12,0,3.545,0.96455,829.402312,0,7049.919652,2488.206936,414.701156,4769.063294,2,29
5,2,1,400,20,1,400,18,1,2.99,0.9701,412.3286259,412.3286259,8246.572518,7421.915266,412.3286259,7834.243892,2,38
5,2,2,400,18,0,400,18,1,3.79,0.9621,0,415.7571978,7483.62956,7483.62956,207.8785989,7483.62956,1,36
5,2,3,400,17,1,400,22,1,3.39,0.9661,414.0358141,414.0358141,7038.60884,9108.78791,414.0358141,8073.698375,2,39
5,2,4,400,13,0,400,20,0,3.805,0.96195,0,0,5405.686366,8316.440563,0,6861.063465,0,33
5,2,5,400,15,0,400,20,0,3.6,0.964,0,0,6224.06639,8298.755187,0,7261.410788,0,35
5,2,6,400,14,0,400,16,0,3.325,0.96675,0,0,5792.604086,6620.118955,0,6206.361521,0,30
5,2,7,400,12,0,400,11,0,4.09,0.9591,0,0,5004.691899,4587.63424,0,4796.16307,0,23
5,2,8,400,16,1,400,10,0,4.12,0.9588,417.1881519,0,6675.01043,4171.881519,208.5940759,5423.445974,1,26
5,2,9,400,14,1,400,15,0,3.4,0.966,414.0786749,0,5797.101449,6211.180124,207.0393375,6004.140787,1,29
5,3,1,200,15,0,200,14,2,3.45,0.9655,0,414.2931124,3107.198343,2900.051787,207.1465562,3003.625065,2,29
5,3,2,400,23,3,400,19,4,4.105,0.95895,1251.368684,1668.491579,9593.826581,7925.335002,1459.930132,8759.580791,7,42
5,3,3,400,13,1,200,14,2,3.53,0.9647,414.6366746,414.6366746,5390.27677,2902.456722,414.6366746,4146.366746,3,27
5,3,4,200,15,0,200,13,0,3.375,0.96625,0,0,3104.786546,2690.815006,0,2897.800776,0,28
5,3,5,200,16,4,200,18,5,3.425,0.96575,828.3717318,1035.464665,3313.486927,3727.672793,931.9181983,3520.57986,9,34
5,3,6,200,14,5,200,14,5,3.485,0.96515,1036.108377,1036.108377,2901.103455,2901.103455,1036.108377,2901.103455,10,28
5,3,7,400,25,7,400,15,3,3.045,0.96955,2887.937703,1237.687587,10314.06323,6188.437935,2062.812645,8251.25058,10,40
5,3,8,200,11,5,100,17,10,3.17,0.9683,1032.737788,1032.737788,2272.023133,1755.654239,1032.737788,2013.838686,15,28
5,3,9,200,12,0,100,16,4,3.05,0.9695,0,412.5838061,2475.502837,1650.335224,206.291903,2062.91903,4,28
5,4,1,200,11,0,100,13,2,5.12,0.9488,0,210.7925801,2318.718381,1370.151771,105.3962901,1844.435076,2,24
5,4,2,100,14,6,100,16,8,6.76,0.9324,643.5006435,858.000858,1501.501502,1716.001716,750.7507508,1608.751609,14,30
5,4,3,200,12,5,100,20,7,7.655,0.92345,1082.895663,758.0269641,2598.949591,2165.791326,920.4613136,2382.370459,12,32
5,4,4,100,12,1,100,18,0,5.435,0.94565,105.7473695,0,1268.968434,1903.452652,52.87368477,1586.210543,1,30
5,4,5,100,22,5,100,21,10,6.84,0.9316,536.7110348,1073.42207,2361.528553,2254.186346,805.0665522,2307.85745,15,43
5,4,6,400,16,2,400,18,3,8.455,0.91545,873.8871593,1310.830739,6991.097275,7864.984434,1092.358949,7428.040854,5,34
5,4,7,100,18,9,200,13,5,5.465,0.94535,952.0283493,1057.809277,1904.056699,2750.30412,1004.918813,2327.180409,14,31
5,4,8,200,15,9,100,18,8,6.595,0.93405,1927.091697,856.4851989,3211.819496,1927.091697,1391.788448,2569.455597,17,33
5,4,9,100,16,2,400,25,1,5.355,0.94645,211.3159702,422.6319404,1690.527762,10565.79851,316.9739553,6128.163136,3,41
5,5,1,100,17,0,200,20,1,4.245,0.95755,0,208.8663777,1775.364211,4177.327555,104.4331889,2976.345883,1,37
5,5,2,200,19,9,200,20,12,3.725,0.96275,1869.644248,2492.858998,3947.026746,4154.764996,2181.251623,4050.895871,21,39
5,5,3,100,16,8,100,17,5,5.105,0.94895,843.0370409,526.8981506,1686.074082,1791.453712,684.9675958,1738.763897,13,33
5,5,4,200,25,1,400,18,0,4.14,0.9586,208.6375965,0,5215.939912,7510.953474,104.3187982,6363.446693,1,43
5,5,5,100,13,4,200,12,4,3.56,0.9644,414.7656574,829.5313148,1347.988387,2488.593944,622.1484861,1918.291165,8,25
5,5,6,100,13,6,100,13,4,4.545,0.95455,628.5684354,419.0456236,1361.898277,1361.898277,523.8070295,1361.898277,10,26
5,5,7,100,16,4,100,16,10,3.645,0.96355,415.1315448,1037.828862,1660.526179,1660.526179,726.4802034,1660.526179,14,32
5,5,8,100,14,0,100,13,1,4.245,0.95755,0,104.4331889,1462.064644,1357.631455,52.21659443,1409.84805,1,27
5,5,9,100,13,1,100,15,0,3.78,0.9622,103.9284972,0,1351.070464,1558.927458,51.9642486,1454.998961,1,28
5,6,1,200,12,1,100,13,4,3.085,0.96915,206.3664035,412.7328071,2476.396843,1341.381623,309.5496053,1908.889233,5,25
5,6,2,100,13,3,100,13,0,3.915,0.96085,312.2235521,0,1352.968726,1352.968726,156.111776,1352.968726,3,26
5,6,3,200,13,0,400,12,0,3.535,0.96465,0,0,2695.27808,4975.897994,0,3835.588037,0,25
5,6,4,100,10,0,200,14,0,3.55,0.9645,0,0,1036.806636,2903.05858,0,1969.932608,0,24
5,6,5,100,19,1,100,15,0,3.235,0.96765,103.3431509,0,1963.519868,1550.147264,51.67157547,1756.833566,1,34
5,6,6,100,20,0,100,21,0,3.39,0.9661,0,0,2070.17907,2173.688024,0,2121.933547,0,41
5,6,7,200,20,0,200,16,0,3.205,0.96795,0,0,4132.444858,3305.955886,0,3719.200372,0,36
5,6,8,100,20,3,200,11,3,3.33,0.9667,310.3341264,620.6682528,2068.894176,2275.783594,465.5011896,2172.338885,6,31
5,6,9,100,16,3,200,14,1,3.285,0.96715,310.1897327,206.7931551,1654.345241,2895.104172,258.4914439,2274.724707,4,30
5,7,1,200,17,0,200,14,0,3.27,0.9673,0,0,3514.938489,2894.655226,0,3204.796857,0,31
5,7,2,200,16,0,200,14,0,3.15,0.9685,0,0,3304.078472,2891.068663,0,3097.573567,0,30
5,7,3,100,19,0,100,15,0,3.325,0.96675,0,0,1965.347815,1551.59038,0,1758.469097,0,34
5,7,4,400,17,0,200,23,0,3.185,0.96815,0,0,7023.705004,4751.329856,0,5887.51743,0,40
5,7,5,100,14,0,100,15,0,3.535,0.96465,0,0,1451.303582,1554.968123,0,1503.135852,0,29
5,7,6,400,25,0,400,22,0,3.875,0.96125,0,0,10403.12094,9154.746424,0,9778.93368,0,47
5,7,7,200,15,0,200,21,0,3.125,0.96875,0,0,3096.774194,4335.483871,0,3716.129032,0,36
5,7,8,200,21,1,200,16,2,3.095,0.96905,206.3876993,412.7753986,4334.141685,3302.203189,309.5815489,3818.172437,3,37
5,7,9,200,30,15,200,16,7,3.465,0.96535,3107.681152,1450.251204,6215.362304,3314.859895,2278.966178,4765.1111,22,46
5,8,1,200,21,1,200,14,0,3.27,0.9673,206.7610876,0,4341.982839,2894.655226,103.3805438,3618.319032,1,35
5,8,2,100,19,0,100,15,0,3.085,0.96915,0,0,1960.480834,1547.748027,0,1754.11443,0,34
5,8,3,100,23,0,100,22,0,3.205,0.96795,0,0,2376.155793,2272.844672,0,2324.500232,0,45
5,8,4,100,13,0,100,10,0,3.535,0.96465,0,0,1347.63904,1036.645415,0,1192.142228,0,23
5,8,5,200,16,0,100,21,1,3.225,0.96775,0,103.3324722,3306.639111,2169.981917,51.66623611,2738.310514,1,37
5,8,6,100,14,0,100,19,0,3.23,0.9677,0,0,1446.729358,1963.418415,0,1705.073887,0,33
5,8,7,100,20,1,100,19,1,3.27,0.9673,103.3805438,103.3805438,2067.610876,1964.230332,103.3805438,2015.920604,2,39
5,8,8,200,13,0,200,13,0,3.55,0.9645,0,0,2695.697252,2695.697252,0,2695.697252,0,26
5,8,9,100,20,0,100,17,0,3.065,0.96935,0,0,2063.238252,1753.752515,0,1908.495384,0,37
5,9,1,200,18,0,200,15,0,2.725,0.97275,0,0,3700.848111,3084.040093,0,3392.444102,0,33
5,9,2,100,23,0,200,23,0,2.84,0.9716,0,0,2367.229312,4734.458625,0,3550.843969,0,46
5,9,3,200,17,0,200,17,0,2.81,0.9719,0,0,3498.302294,3498.302294,0,3498.302294,0,34
5,9,4,200,17,0,100,17,0,2.565,0.97435,0,0,3489.505824,1744.752912,0,2617.129368,0,34
5,9,5,100,19,0,100,15,0,2.76,0.9724,0,0,1953.928425,1542.575072,0,1748.251748,0,34
5,9,6,200,20,0,200,22,0,3.235,0.96765,0,0,4133.726037,4547.098641,0,4340.412339,0,42
5,9,7,100,18,0,200,14,0,2.765,0.97235,0,0,1851.185273,2879.621535,0,2365.403404,0,32
5,9,8,100,25,1,100,12,0,2.595,0.97405,102.6641343,0,2566.603357,1231.969611,51.33206714,1899.286484,1,37
5,9,9,100,26,0,100,19,1,2.53,0.9747,0,102.5956705,2667.487432,1949.317739,51.29783523,2308.402585,1,45
6,1,1,200,20,1,200,15,0,2.805,0.97195,205.7719018,0,4115.438037,3086.578528,102.8859509,3601.008282,1,35
6,1,2,100,11,0,100,12,0,2.785,0.97215,0,0,1131.512627,1234.377411,0,1182.945019,0,23
6,1,3,400,25,0,400,24,1,2.825,0.97175,0,411.6285053,10290.71263,9879.084127,205.8142526,10084.89838,1,49
6,1,4,100,16,0,200,15,0,3.035,0.96965,0,0,1650.079926,3093.899861,0,2371.989893,0,31
6,1,5,200,11,0,100,24,0,3.36,0.9664,0,0,2276.490066,2483.443709,0,2379.966887,0,35
6,1,6,200,14,0,400,12,1,3.695,0.96305,0,415.3470744,2907.429521,4984.164893,207.6735372,3945.797207,1,26
6,1,7,200,21,2,200,12,4,2.74,0.9726,411.2687641,822.5375283,4318.322023,2467.612585,616.9031462,3392.967304,6,33
6,1,8,200,11,2,100,13,2,2.465,0.97535,410.1091916,205.0545958,2255.600554,1332.854873,307.5818937,1794.227713,4,24
6,1,9,200,18,2,200,15,2,3.05,0.9695,412.5838061,412.5838061,3713.254255,3094.378546,412.5838061,3403.8164,4,33
6,2,1,400,17,4,400,16,2,4.715,0.95285,1679.173007,839.5865036,7136.485281,6716.692029,1259.379755,6926.588655,6,33
6,2,2,400,19,1,200,16,1,2.595,0.97405,410.6565371,205.3282686,7802.474206,3285.252297,307.9924029,5543.863251,2,35
6,2,3,400,22,1,400,19,0,2.7,0.973,411.0996917,0,9044.193217,7810.894142,205.5498458,8427.543679,1,41
6,2,4,400,14,0,400,10,0,2.875,0.97125,0,0,5765.765766,4118.404118,0,4942.084942,0,24
6,2,5,200,15,0,200,19,0,2.535,0.97465,0,0,3078.02801,3898.835479,0,3488.431745,0,34
6,2,6,200,14,0,200,24,0,2.69,0.9731,0,0,2877.402117,4932.689343,0,3905.04573,0,38
6,2,7,200,12,0,200,12,2,2.98,0.9702,0,412.2861266,2473.716759,2473.716759,206.1430633,2473.716759,2,24
6,2,8,400,15,0,200,13,1,2.945,0.97055,0,206.0687239,6182.061718,2678.893411,103.034362,4430.477564,1,28
6,2,9,400,12,1,400,10,0,3.02,0.9698,412.4561765,0,4949.474118,4124.561765,206.2280883,4537.017942,1,22
6,3,1,200,15,2,200,21,1,2.98,0.9702,412.2861266,206.1430633,3092.145949,4329.004329,309.2145949,3710.575139,3,36
6,3,2,200,12,0,200,15,1,3.26,0.9674,0,206.7397147,2480.876576,3101.09572,103.3698573,2790.986148,1,27
6,3,3,200,12,4,100,21,3,2.93,0.9707,824.1475224,309.0553209,2472.442567,2163.387246,566.6014217,2317.914907,7,33
6,3,4,100,18,0,100,17,5,3.8,0.962,0,519.7505198,1871.101871,1767.151767,259.8752599,1819.126819,5,35
6,3,5,200,13,0,200,10,0,3.04,0.9696,0,0,2681.518152,2062.706271,0,2372.112211,0,23
6,3,6,100,14,1,100,14,1,2.715,0.97285,102.7907694,102.7907694,1439.070771,1439.070771,102.7907694,1439.070771,2,28
6,3,7,200,18,0,200,13,0,3.115,0.96885,0,0,3715.745471,2683.593952,0,3199.669712,0,31
6,3,8,200,12,3,200,17,3,2.5,0.975,615.3846154,615.3846154,2461.538462,3487.179487,615.3846154,2974.358974,6,29
6,3,9,200,17,7,200,17,7,2.795,0.97205,1440.255131,1440.255131,3497.762461,3497.762461,1440.255131,3497.762461,14,34
6,4,1,100,18,0,200,10,1,3.36,0.9664,0,206.9536424,1862.582781,2069.536424,103.4768212,1966.059603,1,28
6,4,2,200,13,0,100,12,0,3.54,0.9646,0,0,2695.41779,1244.03898,0,1969.728385,0,25
6,4,3,100,16,4,100,16,5,3.2,0.968,413.2231405,516.5289256,1652.892562,1652.892562,464.8760331,1652.892562,9,32
6,4,4,100,12,0,100,12,0,3.465,0.96535,0,0,1243.072461,1243.072461,0,1243.072461,0,24
6,4,5,100,15,1,100,16,1,3.58,0.9642,103.7129226,103.7129226,1555.693839,1659.406762,103.7129226,1607.550301,2,31
6,4,6,100,12,2,200,21,1,3.215,0.96785,206.6435915,206.6435915,1239.861549,4339.515421,206.6435915,2789.688485,3,33
6,4,7,200,17,5,200,18,4,3.13,0.9687,1032.311345,825.8490761,3509.858573,3716.320842,929.0802106,3613.089708,9,35
6,4,8,100,16,6,100,23,3,3.375,0.96625,620.9573092,310.4786546,1655.886158,2380.336352,465.7179819,2018.111255,9,39
6,4,9,400,25,5,200,27,0,3.035,0.96965,2062.599907,0,10312.99954,5569.019749,1031.299954,7941.009643,5,52
6,5,1,100,17,2,100,18,4,3.89,0.9611,208.0948913,416.1897825,1768.806576,1872.854021,312.1423369,1820.830299,6,35
6,5,2,100,14,4,100,16,6,4.075,0.95925,416.992442,625.488663,1459.473547,1667.969768,521.2405525,1563.721658,10,30
6,5,3,200,14,2,100,17,8,2.86,0.9714,411.776817,823.5536339,2882.437719,1750.051472,617.6652254,2316.244595,10,31
6,5,4,100,10,0,100,10,0,2.82,0.9718,0,0,1029.018317,1029.018317,0,1029.018317,0,20
6,5,5,100,11,2,100,10,1,2.935,0.97065,206.0474939,103.023747,1133.261217,1030.23747,154.5356205,1081.749343,3,21
6,5,6,100,10,6,100,23,5,3.205,0.96795,619.8667287,516.5556072,1033.111214,2376.155793,568.2111679,1704.633504,11,33
6,5,7,100,12,1,100,11,2,2.935,0.97065,103.023747,206.0474939,1236.284964,1133.261217,154.5356205,1184.77309,3,23
6,5,8,100,12,3,100,11,2,3.69,0.9631,311.4941335,207.6627557,1245.976534,1142.145156,259.5784446,1194.060845,5,23
6,5,9,100,12,0,100,11,0,3.46,0.9654,0,0,1243.00808,1139.424073,0,1191.216076,0,23
6,6,1,100,11,0,100,10,0,3.09,0.9691,0,0,1135.07378,1031.885254,0,1083.479517,0,21
6,6,2,200,13,0,100,25,0,2.965,0.97035,0,0,2679.445561,2576.389962,0,2627.917762,0,38
6,6,3,100,10,0,100,15,0,3.075,0.96925,0,0,1031.725561,1547.588342,0,1289.656951,0,25
6,6,4,200,10,0,100,12,0,3.12,0.9688,0,0,2064.409579,1238.645747,0,1651.527663,0,22
6,6,5,100,10,0,100,11,1,2.845,0.97155,0,102.9283104,1029.283104,1132.211415,51.46415522,1080.74726,1,21
6,6,6,100,12,0,100,18,0,2.955,0.97045,0,0,1236.53975,1854.809624,0,1545.674687,0,30
6,6,7,100,15,0,100,14,0,3.07,0.9693,0,0,1547.508511,1444.341277,0,1495.924894,0,29
6,6,8,100,10,0,100,12,0,2.97,0.9703,0,0,1030.60909,1236.730908,0,1133.669999,0,22
6,6,9,200,10,0,100,19,0,2.98,0.9702,0,0,2061.430633,1958.359101,0,2009.894867,0,29
6,7,1,100,12,0,100,10,0,2.425,0.97575,0,0,1229.823213,1024.852677,0,1127.337945,0,22
6,7,2,100,12,0,100,10,0,2.25,0.9775,0,0,1227.621483,1023.017903,0,1125.319693,0,22
6,7,3,100,12,1,100,11,0,2.27,0.9773,102.3227259,0,1227.872711,1125.549985,51.16136294,1176.711348,1,23
6,7,4,100,13,0,100,8,0,2.35,0.9765,0,0,1331.285202,819.2524322,0,1075.268817,0,21
6,7,5,200,16,0,200,16,0,2.175,0.97825,0,0,3271.147457,3271.147457,0,3271.147457,0,32
6,7,6,100,13,0,100,15,0,2.265,0.97735,0,0,1330.127385,1534.762368,0,1432.444876,0,28
6,7,7,100,10,0,100,10,0,2.155,0.97845,0,0,1022.024631,1022.024631,0,1022.024631,0,20
6,7,8,100,13,0,100,7,0,2.285,0.97715,0,0,1330.399632,716.3690324,0,1023.384332,0,20
6,7,9,100,15,0,100,16,0,2.325,0.97675,0,0,1535.705145,1638.085488,0,1586.895316,0,31
6,8,1,100,10,0,100,11,0,2.275,0.97725,0,0,1023.279611,1125.607572,0,1074.443592,0,21
6,8,2,100,10,0,100,14,0,2.92,0.9708,0,0,1030.078286,1442.1096,0,1236.093943,0,24
6,8,3,100,20,0,100,18,0,2.26,0.9774,0,0,2046.24514,1841.620626,0,1943.932883,0,38
6,8,4,100,10,0,100,10,0,2.225,0.97775,0,0,1022.756328,1022.756328,0,1022.756328,0,20
6,8,5,100,12,0,100,10,0,2.205,0.97795,0,0,1227.056598,1022.547165,0,1124.801881,0,22
6,8,6,100,10,0,100,11,0,2.365,0.97635,0,0,1024.222871,1126.645158,0,1075.434014,0,21
6,8,7,100,10,0,100,14,0,2.295,0.97705,0,0,1023.489074,1432.884704,0,1228.186889,0,24
6,8,8,100,17,0,100,10,0,2.4,0.976,0,0,1741.803279,1024.590164,0,1383.196721,0,27
6,8,9,100,12,0,100,10,1,2.265,0.97735,0,102.3174912,1227.809894,1023.174912,51.15874559,1125.492403,1,22
6,9,1,100,14,0,100,14,0,2.105,0.97895,0,0,1430.103683,1430.103683,0,1430.103683,0,28
6,9,2,200,15,0,100,14,0,2.615,0.97385,0,0,3080.556554,1437.593058,0,2259.074806,0,29
6,9,3,100,18,1,100,16,0,2.245,0.97755,102.2965577,0,1841.338039,1636.744924,51.14827886,1739.041481,1,34
6,9,4,100,10,0,100,11,0,1.17,0.9883,0,0,1011.838511,1113.022362,0,1062.430436,0,21
6,9,5,100,14,0,100,10,0,2.185,0.97815,0,0,1431.273322,1022.338087,0,1226.805705,0,24
6,9,6,100,17,0,200,12,0,2.665,0.97335,0,0,1746.545436,2465.711204,0,2106.12832,0,29
6,9,7,100,15,0,100,16,0,2.32,0.9768,0,0,1535.626536,1638.001638,0,1586.814087,0,31
6,9,8,100,14,0,100,11,0,2.24,0.9776,0,0,1432.07856,1125.204583,0,1278.641571,0,25
6,9,9,100,15,0,100,14,0,2.59,0.9741,0,0,1539.882969,1437.224104,0,1488.553537,0,29
7,1,1,100,10,0,100,10,2,2.28,0.9772,0,204.6663938,1023.331969,1023.331969,102.3331969,1023.331969,2,20
7,1,2,200,10,0,100,16,5,5,0.95,0,526.3157895,2105.263158,1684.210526,263.1578947,1894.736842,5,26
7,1,3,100,16,7,100,16,4,2.19,0.9781,715.673244,408.9561395,1635.824558,1635.824558,562.3146917,1635.824558,11,32
7,1,4,200,11,1,100,10,0,2.71,0.9729,205.5709734,0,2261.280707,1027.854867,102.7854867,1644.567787,1,21
7,1,5,100,12,3,100,13,4,4.18,0.9582,313.0870382,417.4493843,1252.348153,1356.710499,365.2682112,1304.529326,7,25
7,1,6,100,14,0,100,12,0,2.62,0.9738,0,0,1437.666872,1232.28589,0,1334.976381,0,26
7,1,7,100,10,0,100,10,3,2.31,0.9769,0,307.0938684,1023.646228,1023.646228,153.5469342,1023.646228,3,20
7,1,8,100,11,3,100,20,8,5.6,0.944,317.7966102,847.4576271,1165.254237,2118.644068,582.6271186,1641.949153,11,31
7,1,9,100,23,12,100,25,21,2.16,0.9784,1226.492232,2146.361406,2350.776778,2555.19215,1686.426819,2452.984464,33,48
7,2,1,100,16,2,100,16,2,4.04,0.9596,208.4201751,208.4201751,1667.361401,1667.361401,208.4201751,1667.361401,4,32
7,2,2,200,10,0,100,18,8,7.26,0.9274,0,862.6266983,2156.566746,1940.910071,431.3133491,2048.738408,8,28
7,2,3,200,14,0,200,15,0,2.94,0.9706,0,0,2884.813517,3090.871626,0,2987.842572,0,29
7,2,4,100,10,0,100,10,0,2.92,0.9708,0,0,1030.078286,1030.078286,0,1030.078286,0,20
7,2,5,100,15,0,100,15,0,8.01,0.9199,0,0,1630.612023,1630.612023,0,1630.612023,0,30
7,2,6,100,27,0,100,32,1,2.87,0.9713,0,102.9548028,2779.779677,3294.553691,51.47740142,3037.166684,1,59
7,2,7,100,10,0,100,14,0,3.38,0.9662,0,0,1034.982405,1448.975367,0,1241.978886,0,24
7,2,8,100,13,1,100,16,1,7.61,0.9239,108.2368222,108.2368222,1407.078688,1731.789155,108.2368222,1569.433921,2,29
7,2,9,100,22,1,100,23,2,2.95,0.9705,103.0396703,206.0793405,2266.872746,2369.912416,154.5595054,2318.392581,3,45
7,3,1,200,30,17,200,29,16,2.26,0.9774,3478.616738,3273.992224,6138.735421,5934.110906,3376.304481,6036.423163,33,59
7,3,2,200,25,6,200,25,2,8.51,0.9149,1311.618756,437.206252,5465.078151,5465.078151,874.4125041,5465.078151,8,50
7,3,3,100,21,3,200,23,2,2.25,0.9775,306.9053708,409.2071611,2148.337596,4705.882353,358.056266,3427.109974,5,44
7,3,4,100,14,1,100,17,7,2.64,0.9736,102.7115859,718.9811011,1437.962202,1746.09696,410.8463435,1592.029581,8,31
7,3,5,200,24,11,200,28,19,6.38,0.9362,2349.92523,4058.96176,5127.109592,5981.627857,3204.443495,5554.368725,30,52
7,3,6,100,18,1,100,18,1,2.41,0.9759,102.4695153,102.4695153,1844.451276,1844.451276,102.4695153,1844.451276,2,36
7,3,7,100,11,2,200,12,0,2.13,0.9787,204.3527128,0,1123.93992,2452.232553,102.1763564,1788.086237,2,23
7,3,8,200,14,5,200,17,7,4.53,0.9547,1047.449461,1466.429245,2932.85849,3561.328166,1256.939353,3247.093328,12,31
7,3,9,200,13,3,200,20,1,2.19,0.9781,613.4342092,204.4780697,2658.214906,4089.561395,408.9561395,3373.88815,4,33
7,4,1,100,13,1,100,11,0,2.06,0.9794,102.1033286,0,1327.343271,1123.136614,51.05166428,1225.239943,1,24
7,4,2,100,13,4,100,12,4,2.28,0.9772,409.3327876,409.3327876,1330.33156,1227.998363,409.3327876,1279.164961,8,25
7,4,3,200,21,7,200,25,7,2.17,0.9783,1431.053869,1431.053869,4293.161607,5110.906675,1431.053869,4702.034141,14,46
7,4,4,100,10,3,100,10,0,2.1,0.979,306.4351379,0,1021.45046,1021.45046,153.2175689,1021.45046,3,20
7,4,5,200,15,12,200,12,5,2.74,0.9726,2467.612585,1028.17191,3084.515731,2467.612585,1747.892248,2776.064158,17,27
7,4,6,200,26,20,200,24,18,2.62,0.9738,4107.619634,3696.857671,5339.905525,4929.143561,3902.238653,5134.524543,38,50
7,4,7,100,10,9,100,11,6,2.29,0.9771,921.0930304,614.0620203,1023.4367,1125.78037,767.5775253,1074.608535,15,21
7,4,8,100,15,3,100,12,3,1.99,0.9801,306.0912152,306.0912152,1530.456076,1224.364861,306.0912152,1377.410468,6,27
7,4,9,200,21,9,200,19,9,1.98,0.9802,1836.359927,1836.359927,4284.839829,3876.759845,1836.359927,4080.799837,18,40
7,5,1,100,14,1,100,14,0,2.28,0.9772,102.3331969,0,1432.664756,1432.664756,51.16659844,1432.664756,1,28
7,5,2,200,16,15,200,20,15,2.84,0.9716,3087.690408,3087.690408,3293.536435,4116.920543,3087.690408,3705.228489,30,36
7,5,3,200,14,6,200,14,0,1.9,0.981,1223.24159,0,2854.230377,2854.230377,611.6207951,2854.230377,6,28
7,5,4,100,14,0,100,10,0,2.33,0.9767,0,0,1433.398178,1023.855841,0,1228.627009,0,24
7,5,5,100,21,3,100,19,3,2.1,0.979,306.4351379,306.4351379,2145.045965,1940.755873,306.4351379,2042.900919,6,40
7,5,6,200,20,4,100,17,7,2.35,0.9765,819.2524322,716.8458781,4096.262161,1740.911418,768.0491551,2918.58679,11,37
7,5,7,100,13,6,100,18,6,2.1,0.979,612.8702758,612.8702758,1327.885598,1838.610827,612.8702758,1583.248212,12,31
7,5,8,100,17,1,100,17,0,2.43,0.9757,102.4905196,0,1742.338834,1742.338834,51.24525981,1742.338834,1,34
7,5,9,200,13,0,200,12,0,2.17,0.9783,0,0,2657.671471,2453.235204,0,2555.453337,0,25
7,6,1,100,15,0,100,16,1,1.86,0.9814,0,101.8952517,1528.428775,1630.324027,50.94762584,1579.376401,1,31
7,6,2,100,19,1,200,13,1,1.85,0.9815,101.8848701,203.7697402,1935.812532,2649.006623,152.8273051,2292.409577,2,32
7,6,3,100,19,0,100,22,0,1.86,0.9814,0,0,1936.009782,2241.695537,0,2088.852659,0,41
7,6,4,200,15,0,200,17,0,1.91,0.9809,0,0,3058.415741,3466.204506,0,3262.310123,0,32
7,6,5,100,15,0,100,12,0,1.88,0.9812,0,0,1528.740318,1222.992254,0,1375.866286,0,27
7,6,6,200,18,0,200,19,0,1.95,0.9805,0,0,3671.596124,3875.573687,0,3773.584906,0,37
7,6,7,200,15,0,200,17,1,1.83,0.9817,0,203.7282265,3055.923398,3463.379851,101.8641133,3259.651625,1,32
7,6,8,200,24,1,200,30,3,2.36,0.9764,204.8340844,614.5022532,4916.018025,6145.022532,409.6681688,5530.520279,4,54
7,6,9,200,25,0,400,16,0,1.92,0.9808,0,0,5097.879282,6525.285481,0,5811.582382,0,41
7,7,1,200,9,0,100,11,0,1.63,0.9837,0,0,1829.826167,1118.227102,0,1474.026634,0,20
7,7,2,200,18,0,200,16,0,1.98,0.9802,0,0,3672.719853,3264.639869,0,3468.679861,0,34
7,7,3,100,12,0,400,11,0,1.83,0.9817,0,0,1222.369359,4482.020984,0,2852.195172,0,23
7,7,4,100,12,0,100,11,0,1.74,0.9826,0,0,1221.249746,1119.478933,0,1170.36434,0,23
7,7,5,400,10,0,400,10,0,1.93,0.9807,0,0,4078.719282,4078.719282,0,4078.719282,0,20
7,7,6,400,20,3,400,22,3,2.04,0.9796,1224.989792,1224.989792,8166.598612,8983.258473,1224.989792,8574.928542,6,42
7,7,7,100,5,0,100,11,0,1.79,0.9821,0,0,509.1131249,1120.048875,0,814.5809999,0,16
7,7,8,200,14,0,200,18,0,2.09,0.9791,0,0,2859.769176,3676.846083,0,3268.307629,0,32
7,7,9,200,7,0,200,20,0,1.87,0.9813,0,0,1426.678895,4076.225415,0,2751.452155,0,27
7,8,1,200,18,0,200,14,0,1.9,0.981,0,0,3669.724771,2854.230377,0,3261.977574,0,32
7,8,2,100,18,2,100,18,0,4.89,0.9511,210.2828304,0,1892.545474,1892.545474,105.1414152,1892.545474,2,36
7,8,3,200,13,0,200,19,0,2.01,0.9799,0,0,2653.331973,3877.946729,0,3265.639351,0,32
7,8,4,200,14,0,200,10,0,2.56,0.9744,0,0,2873.563218,2052.545156,0,2463.054187,0,24
7,8,5,200,14,0,200,16,0,7.94,0.9206,0,0,3041.494677,3475.993917,0,3258.744297,0,30
7,8,6,100,14,0,100,22,0,4.33,0.9567,0,0,1463.363646,2299.571444,0,1881.467545,0,36
7,8,7,100,14,0,100,18,0,2.14,0.9786,0,0,1430.615165,1839.362354,0,1634.988759,0,32
7,8,8,200,10,0,200,10,0,11.7,0.883,0,0,2265.005663,2265.005663,0,2265.005663,0,20
7,8,9,200,10,0,200,10,0,2.04,0.9796,0,0,2041.649653,2041.649653,0,2041.649653,0,20
7,9,1,100,15,0,100,15,0,1.59,0.9841,0,0,1524.235342,1524.235342,0,1524.235342,0,30
7,9,2,200,13,0,200,12,0,1.69,0.9831,0,0,2644.695351,2441.257247,0,2542.976299,0,25
7,9,3,400,18,0,400,18,0,1.61,0.9839,0,0,7317.816851,7317.816851,0,7317.816851,0,36
7,9,4,400,12,0,400,13,0,1.61,0.9839,0,0,4878.544568,5285.089948,0,5081.817258,0,25
7,9,5,200,15,0,200,10,0,2.09,0.9791,0,0,3064.038403,2042.692268,0,2553.365336,0,25
7,9,6,400,13,0,400,14,0,1.9,0.981,0,0,5300.713558,5708.460754,0,5504.587156,0,27
7,9,7,200,12,0,200,12,0,1.86,0.9814,0,0,2445.48604,2445.48604,0,2445.48604,0,24
7,9,8,400,26,0,400,27,0,1.8,0.982,0,0,10590.63136,10997.96334,0,10794.29735,0,53
7,9,9,400,17,0,400,20,0,2.1,0.979,0,0,6945.863126,8171.603677,0,7558.733401,0,37
8,1,1,100,15,9,100,12,6,4.17,0.9583,939.1631013,626.1087342,1565.271836,1252.217468,782.6359178,1408.744652,15,27
8,1,2,200,14,1,200,13,1,3.81,0.9619,207.9218214,207.9218214,2910.9055,2702.983678,207.9218214,2806.944589,2,27
8,1,3,200,17,2,200,11,2,2.6,0.974,410.6776181,410.6776181,3490.759754,2258.726899,410.6776181,2874.743326,4,28
8,1,4,100,10,0,100,10,0,2.86,0.9714,0,0,1029.442042,1029.442042,0,1029.442042,0,20
8,1,5,100,13,1,100,15,0,3.91,0.9609,104.0691019,0,1352.898324,1561.036528,52.03455094,1456.967426,1,28
8,1,6,100,21,1,100,23,3,3.36,0.9664,103.4768212,310.4304636,2173.013245,2379.966887,206.9536424,2276.490066,4,44
8,1,7,100,16,3,100,15,2,2.65,0.9735,308.1664099,205.4442732,1643.554186,1540.832049,256.8053416,1592.193118,5,31
8,1,8,100,25,15,100,25,15,7.36,0.9264,1619.170984,1619.170984,2698.618307,2698.618307,1619.170984,2698.618307,30,50
8,1,9,400,30,14,400,30,18,4.39,0.9561,5857.127915,7530.593034,12550.98839,12550.98839,6693.860475,12550.98839,32,60
8,2,1,100,17,3,100,20,4,2.24,0.9776,306.8739771,409.1653028,1738.952537,2045.826514,358.0196399,1892.389525,7,37
8,2,2,400,22,1,400,18,0,9.35,0.9065,441.2575841,0,9707.666851,7942.636514,220.6287921,8825.151682,1,40
8,2,3,200,25,4,200,24,2,3.87,0.9613,832.2063872,416.1031936,5201.28992,4993.238323,624.1547904,5097.264122,6,49
8,2,4,200,13,0,200,10,1,3.54,0.9646,0,207.33983,2695.41779,2073.3983,103.669915,2384.408045,1,23
8,2,5,200,18,0,200,21,0,6.87,0.9313,0,0,3865.564265,4509.824976,0,4187.69462,0,39
8,2,6,400,20,1,400,18,0,6.01,0.9399,425.5771891,0,8511.543781,7660.389403,212.7885945,8085.966592,1,38
8,2,7,100,13,0,100,12,0,9.09,0.9091,0,0,1429.9857,1319.9868,0,1374.98625,0,25
8,2,8,100,12,0,100,11,0,6.31,0.9369,0,0,1280.819725,1174.084748,0,1227.452236,0,23
8,2,9,200,21,0,200,18,0,2.96,0.9704,0,0,4328.112119,3709.810387,0,4018.961253,0,39
8,3,1,200,22,4,200,18,4,4.35,0.9565,836.3826451,836.3826451,4600.104548,3763.721903,836.3826451,4181.913225,8,40
8,3,2,100,16,0,100,14,0,8.35,0.9165,0,0,1745.771959,1527.550464,0,1636.661211,0,30
8,3,3,400,17,4,400,15,4,3.21,0.9679,1653.063333,1653.063333,7025.519165,6198.987499,1653.063333,6612.253332,8,32
8,3,4,100,14,7,100,16,4,3.32,0.9668,724.0380637,413.7360364,1448.076127,1654.944146,568.8870501,1551.510137,11,30
8,3,5,200,22,4,200,20,6,3.89,0.9611,832.3795651,1248.569348,4578.087608,4161.897825,1040.474456,4369.992717,10,42
8,3,6,100,25,2,100,20,6,2.91,0.9709,205.9944382,617.9833145,2574.930477,2059.944382,411.9888763,2317.437429,8,45
8,3,7,100,16,3,200,16,1,3.06,0.9694,309.4697751,206.3131834,1650.505467,3301.010935,257.8914793,2475.758201,4,32
8,3,8,200,18,9,200,23,15,7.62,0.9238,1948.473696,3247.456159,3896.947391,4979.432778,2597.964927,4438.190084,24,41
8,3,9,200,17,7,200,13,1,2.29,0.9771,1432.811381,204.6873401,3479.684781,2660.935421,818.7493604,3070.310101,8,30
8,4,1,100,10,0,100,10,0,3.16,0.9684,0,0,1032.631144,1032.631144,0,1032.631144,0,20
8,4,2,100,13,7,200,10,2,4.69,0.9531,734.4454937,419.6831392,1363.970202,2098.415696,577.0643164,1731.192949,9,23
8,4,3,200,18,12,200,17,5,10.58,0.8942,2683.963319,1118.31805,4025.944979,3802.281369,1901.140684,3914.113174,17,35
8,4,4,100,11,5,100,10,4,9.09,0.9091,549.9945001,439.9956,1209.9879,1099.989,494.99505,1154.98845,9,21
8,4,5,200,18,14,200,19,15,7.8,0.922,3036.876356,3253.796095,3904.555315,4121.475054,3145.336226,4013.015184,29,37
8,4,6,200,16,11,200,20,4,3.45,0.9655,2278.612118,828.5862248,3314.344899,4142.931124,1553.599171,3728.638011,15,36
8,4,7,100,13,7,100,16,15,6.93,0.9307,752.1220587,1611.690126,1396.798109,1719.136134,1181.906092,1557.967122,22,29
8,4,8,200,14,8,200,14,11,5.37,0.9463,1690.795731,2324.84413,2958.892529,2958.892529,2007.81993,2958.892529,19,28
8,4,9,200,12,1,200,13,3,9.33,0.9067,220.5801257,661.7403772,2646.961509,2867.541634,441.1602515,2757.251572,4,25
8,5,1,100,19,1,100,12,1,5.22,0.9478,105.507491,105.507491,2004.64233,1266.089892,105.507491,1635.366111,2,31
8,5,2,200,17,11,200,16,11,3.82,0.9618,2287.377833,2287.377833,3535.03847,3327.09503,2287.377833,3431.06675,22,33
8,5,3,200,12,11,100,21,17,8.22,0.9178,2397.036391,1852.255393,2614.948791,2288.080192,2124.645892,2451.514491,28,33
8,5,4,100,10,1,100,14,1,7.33,0.9267,107.9097874,107.9097874,1079.097874,1510.737024,107.9097874,1294.917449,2,24
8,5,5,100,10,2,100,11,4,5.17,0.9483,210.9037225,421.8074449,1054.518612,1159.970473,316.3555837,1107.244543,6,21
8,5,6,100,24,9,200,13,4,5.69,0.9431,954.2996501,848.2663556,2544.799067,2756.865656,901.2830029,2650.832361,13,37
8,5,7,100,14,2,100,14,3,7.95,0.9205,217.2732211,325.9098316,1520.912548,1520.912548,271.5915263,1520.912548,5,28
8,5,8,100,17,2,100,21,7,5.22,0.9478,211.0149821,738.5524372,1793.627348,2215.657312,474.7837096,2004.64233,9,38
8,5,9,100,23,0,100,20,0,3.99,0.9601,0,0,2395.583793,2083.116342,0,2239.350068,0,43
8,6,1,100,14,0,100,12,0,4.97,0.9503,0,0,1473.218983,1262.759129,0,1367.989056,0,26
8,6,2,200,19,0,200,13,0,13.3,0.867,0,0,4382.929642,2998.846597,0,3690.88812,0,32
8,6,3,200,12,0,200,14,0,6.34,0.9366,0,0,2562.459962,2989.536622,0,2775.998292,0,26
8,6,4,200,18,0,200,22,0,6.36,0.9364,0,0,3844.510893,4698.846647,0,4271.67877,0,40
8,6,5,200,18,0,200,17,0,4.87,0.9513,0,0,3784.295175,3574.056554,0,3679.175865,0,35
8,6,6,200,18,1,200,18,3,7.48,0.9252,216.1694769,648.5084306,3891.050584,3891.050584,432.3389537,3891.050584,4,36
8,6,7,200,13,0,200,20,0,4.73,0.9527,0,0,2729.085756,4198.593471,0,3463.839614,0,33
8,6,8,200,24,1,200,23,0,7.26,0.9274,215.6566746,0,5175.76019,4960.103515,107.8283373,5067.931852,1,47
8,6,9,200,27,1,200,27,0,8.49,0.9151,218.5553491,0,5900.994427,5900.994427,109.2776746,5900.994427,1,54
8,7,1,200,16,0,200,15,0,2.3,0.977,0,0,3275.332651,3070.62436,0,3172.978506,0,31
8,7,2,100,14,0,100,11,0,2.26,0.9774,0,0,1432.371598,1125.434827,0,1278.903213,0,25
8,7,3,100,17,0,100,16,0,1.9,0.981,0,0,1732.925586,1630.988787,0,1681.957187,0,33
8,7,4,100,11,0,100,10,0,3.56,0.9644,0,0,1140.605558,1036.914144,0,1088.759851,0,21
8,7,5,100,16,0,100,16,1,2.08,0.9792,0,102.124183,1633.986928,1633.986928,51.0620915,1633.986928,1,32
8,7,6,100,12,0,100,10,0,3.59,0.9641,0,0,1244.684161,1037.236801,0,1140.960481,0,22
8,7,7,100,10,0,100,10,0,3.47,0.9653,0,0,1035.947374,1035.947374,0,1035.947374,0,20
8,7,8,100,12,0,100,12,0,6.88,0.9312,0,0,1288.659794,1288.659794,0,1288.659794,0,24
8,7,9,100,12,0,200,10,0,5.93,0.9407,0,0,1275.645796,2126.076326,0,1700.861061,0,22
8,8,1,200,14,1,200,10,0,4.02,0.9598,208.3767452,0,2917.274432,2083.767452,104.1883726,2500.520942,1,24
8,8,2,100,19,0,200,11,0,4.88,0.9512,0,0,1997.476871,2312.867956,0,2155.172414,0,30
8,8,3,200,13,0,100,22,0,3.86,0.9614,0,0,2704.389432,2288.329519,0,2496.359476,0,35
8,8,4,200,12,0,200,11,0,2.58,0.9742,0,0,2463.559844,2258.26319,0,2360.911517,0,23
8,8,5,100,20,0,100,20,0,5.82,0.9418,0,0,2123.59312,2123.59312,0,2123.59312,0,40
8,8,6,200,12,0,200,13,0,3.79,0.9621,0,0,2494.543187,2702.421786,0,2598.482486,0,25
8,8,7,100,11,0,100,16,0,5.41,0.9459,0,0,1162.913627,1691.510731,0,1427.212179,0,27
8,8,8,100,10,0,100,10,0,1.41,0.9859,0,0,1014.301653,1014.301653,0,1014.301653,0,20
8,8,9,200,12,0,200,17,0,2.68,0.9732,0,0,2466.091245,3493.629264,0,2979.860255,0,29
8,9,1,100,16,0,100,15,0,2.17,0.9783,0,0,1635.490136,1533.272002,0,1584.381069,0,31
8,9,2,200,15,0,200,15,0,5.66,0.9434,0,0,3179.98728,3179.98728,0,3179.98728,0,30
8,9,3,400,12,0,400,12,0,5.41,0.9459,0,0,5074.532192,5074.532192,0,5074.532192,0,24
8,9,4,200,14,0,200,15,0,4.21,0.9579,0,0,2923.060862,3131.850924,0,3027.455893,0,29
8,9,5,200,10,0,200,11,0,5.73,0.9427,0,0,2121.565715,2333.722287,0,2227.644001,0,21
8,9,6,200,14,0,200,14,0,5.44,0.9456,0,0,2961.08291,2961.08291,0,2961.08291,0,28
8,9,7,100,12,0,100,17,1,5.86,0.9414,0,106.2247716,1274.697259,1805.821117,53.11238581,1540.259188,1,29
8,9,8,200,13,2,200,11,0,7.37,0.9263,431.8255425,0,2806.866026,2375.040484,215.9127712,2590.953255,2,24
8,9,9,200,12,0,200,17,0,5.22,0.9478,0,0,2532.179785,3587.254695,0,3059.71724,0,29
